111111111111111111
1P0C00000001000001
111110000001111111
111001000000C00001
101111000E01011111
100000000000100001
111111111111111111
